{
	"numTilesX":14,
	"numTilesY":14,
	"size":[64,64],
	"start":[32,32],
	"tileNames":["", "tile01", "tile02"],
	"tiles":[
			1, 1, 1, 1, 1, 1, 1, 1, 1, 1, 1, 1, 1, 1,
			1, 0, 0, 0, 0, 0, 0, 0, 0, 0, 0, 0, 0, 1,
			1, 0, 0, 0, 0, 0, 0, 0, 0, 0, 0, 0, 0, 1,
			1, 2, 2, 0, 0, 0, 0, 0, 0, 0, 0, 2, 2, 1,
			1, 0, 0, 0, 0, 2, 2, 2, 2, 0, 0, 0, 0, 1,
			1, 0, 0, 0, 0, 0, 0, 0, 0, 0, 0, 0, 0, 1,
			1, 2, 2, 0, 2, 0, 0, 0, 0, 2, 2, 0, 2, 1,
			1, 0, 0, 0, 0, 0, 0, 0, 0, 0, 0, 0, 0, 1,
			1, 0, 0, 0, 0, 0, 2, 2, 0, 0, 0, 0, 0, 1,
			1, 0, 0, 0, 0, 0, 0, 0, 0, 0, 0, 0, 0, 1,			
			1, 2, 0, 2, 2, 0, 0, 0, 0, 2, 2, 0, 2, 1,
			1, 0, 0, 0, 0, 0, 0, 0, 0, 0, 0, 0, 0, 1,									
			1, 1, 1, 1, 1, 1, 1, 1, 1, 1, 1, 1, 1, 1			
		    ]
}